###############
#S    #       #
# # # # ##### #
# # # #     # #
# # # ##### # #
#   #     # # #
### ##### # # #
#   #   # # # #
# # # # # # # #
# # # # # # # #
# #   # #   # #
# ##### ##### #
#     #     # #
# ##### ### #E#
###############