#####################
#S  #   #           #
### ### # ##### #####
# #   # # #   #     #
# ### # # # # ##### #
#   # #     #   #   #
# ### ########### # #
# #   #         # # #
# # ### ####### # ###
# # #   # #   # #   #
# # # ### # # # # # #
# #   #   # #   # # #
# ####### # ####### #
#         #     #   #
# # ########### # ###
# #         #   #   #
# ######### # ##### #
# #       #   #   # #
# ### ### ##### # # #
#     #         #  E#
#####################